[Simplified Chinese]
Menu Language=简体中文(&C)

File = 文件(&F)
Open Rom = 打开 Rom(&O)
Free Rom = 关闭 Rom(&C)
Boot cd = 运行光盘(&B)
Netplay = 连网对战(&N)
Game Genie = &Game Genie
Load State as = 载入进度(&L)
Save State as = 另存进度(&S)
Load State = 即时读档(&L)
Save State = 即时存档(&S)
Change State = 选择存档(&H)
Quit = 退出(&Q)
Rom History = Rom 历史(&R)

Graphic = 图形(&G)
Full Screen = 全屏模式(&F)
Windowed = 视窗模式(&W)
VSync = 垂直同步(&V)
Stretch = 全屏伸展(&S)
Color = 颜色设置(&C)
Contrast = 对比度
Brightness = 亮度
Greyscale = 灰度
Invert = 转换
Apply = 应用(&A)
Close = 关闭(&C)
Default = 默认(&D)
Render = 视频渲染(&R)
Normal = 普通
Double = 两倍
Interpolated = 视频柔化
Scanline = 隔行扫描
50% Scanline = 50% 隔行扫描
25% Scanline = 25% 隔行扫描
Interpolated Scanline = 柔化隔行扫描
Interpolated 50% Scanline = 50% 隔行扫描+柔化
Interpolated 25% Scanline = 25% 隔行扫描+柔化
2xSAI (Kreed) = 双倍渲染
Sprite Limit = 活动块限制(&S)
Frame Skip = 跳帧(&F)
Auto = 自动
Screen Shot = 截图(&S)

CPU = 处理器(&C)
Debug = 调试(&D)
VDP = 图形芯片调试(&V)
Country = 国家选择(&C)
Auto detect = 自动检测
Japan (NTSC) = 日本 (NTSC)
USA (NTSC) = 美国 (NTSC)
Europe (PAL) = 欧洲 (PAL)
Japan (PAL) = 日本 (PAL)
Auto detection order = 自动检测顺序
Hard Reset = 硬件复位(&H)
Reset 68K = 复位 68K(&R)
Reset master SH2 = 复位 SH2(主)
Reset slave SH2 = 复位 SH2(次)
Reset Z80 = 复位 Z80(&Z)
Perfect Synchro = 完美同步(较慢)(&P)

Sound = 音频(&S)
Enable = 开启(&E)
Rate = 采样率(&R)
Stereo = 立体声(&S)
YM2612 High Quality = 高质量 YM2612
Start Dump = 录制 WAV 音乐
Stop Dump = 停止 WAV 录制
Start GYM Dump = 导出 GYM 文件
Stop GYM Dump = 停止 GYM 导出

Option = 选项(&O)
Misc = 其它选项(&M)
Joypad = 手柄设置(&J)
Directories = 目录设置(&D)
Bios/Misc Files = BIOS/其它文件(&F)
Current CD Drive = 选择光驱(&C)
Sega cd SRAM Size = 光驱缓存(&R)
None = 不使用
Load config = 载入配置(&L)
Save config as = 另存配置(&S)

Help=帮助(&H)
File menu = 文件菜单(&F)
Graphics menu = 图形菜单(&G)
CPU menu = &CPU菜单
Sound menu = 音频菜单(&S)
Options menu = 选项菜单(&O)
Netplay = 连网对战(&N)
Mega/Sega CD = 主机说明(&M)
FAQ = 问题解答(&F)
Shortcuts = 快捷键(&D)
About = 关于(&A)

OK = 确定(&O)
Cancel = 取消(&C)
Informations GG = 修改说明
Change = 更改
Add Code = 添加代码
Remove selected codes = 删除代码
Desactive all codes = 全部关闭
INFORMATIONS= 信息
Enable=启用
Auto Fix Checksum = 自动修正校验
Fast Blur=动态模糊
Auto Pause = 自动暂停
Show Sega-CD LED = 显示光盘游戏加载指示灯
System = 系统
Double Sized  =两倍大小
Transparency = 透明效果
FPS = 帧频
Message = 信息
Effect Color = 模拟器背景颜色

Setting directories = 设置目录
Save static = 游戏存档
Sram static = SRAM 备份
Bram static = BRAM 备份
Wav static = WAV 存放
Gym static = GYM 存放
Shot static = 截图
Patch static = PAT 补丁
IPS static = IPS 补丁

Setting Genesis bios file = 设置 MEGA DRIVE BIOS 文件
Genesis bios static = MEGA DRIVE BIOS
Setting 32X bios files = 设置 32X BIOS 文件
M SH2 bios static = 主 SH2
S SH2 bios static = 从 SH2
Setting SEGA CD bios files = 设置世嘉 CD BIOS 文件
US bios static = 美国
EU bios static = 欧洲
JA bios static = 日本
Setting misc files = 设置其他文件
CGOffline static = CGO 信息
Manual static = 使用手册

Game Genie info 1 = 游戏支持金手指代码和修改代码：）
Game Genie info 2 = 选择一个代码激活它：）
Game Genie info 3 = 金手指修改语法为：XXXX-XXXX
Game Genie info 4 = 代码修改的语法为：XXXXXX:YYYY    （地址：数值）
Controller info 1 = 只有当一个多人控制器被连接到端口 ① 的时候控制器 1-B  1-C 和 1-D 才能使用。
Controller info 2 = 只有当一个多人控制器被连接到端口 ② 的时候控制器 2-B  2-C 和 2-D 才能使用。
Controller info 3 = 仅有少数游戏支持多人控制器（支持 ④ 个控制器的游戏），因此在设置好控制器的按键后请使用“另存配置”和“载入配置”存取配置文件:)